  -> З
О -> М
И -> Я
Е -> Ъ
А -> Ш
Н -> Е
Т -> Ь
С -> Ы
Р -> Г
В -> С
М -> Н
Л -> А
Д -> Ц
Я -> Ф
К -> Щ
П -> Д
З -> Л
Ы -> О
Ь -> В
У -> П
Ч ->  
Ж -> Р
Г -> Ю
Х -> Х
Ф -> Т
Й -> У
Ю -> И
Б -> Ж
Ц -> Й
Ш -> Б
Щ -> Ч
Э -> К
Ъ -> Э
